DRDIUDRUID
S7I/=7IRUD
R|R|I|IURI
D|I|R|IDUD
I|D|I|R/=F
U|I|R|I|IU
D|R|I|D|RU
R|D|R|I|ID
RL=JIL=JIR
UDIUDURUUI