DURDIDURDI
IRUUR/==7I
DIDIR|DR|I
R/===+==JI
R|IDU|DUDU
UL===+===F
DUDUD|UDDU
S====+==7I
UDUDU|IU|I
RIDIRL==JI